NO ./texture/cobblestone.xpm
SO ./texture/sea.xpm
WE ./texture/znak.xpm
EA ./texture/greengray.xpm

C 139,150,254
F 60,0,0

        1111111111111111111111111
        1000000000110000000000001
        110000011100000000000111
        1001000000000000000000001
111111111011000001110000000000001
100000000011000001110111111111111
11110111111111011100000010001
11110111111111011101010010001
11000000110101011100000010001111111111111
10000000000000011000000000000000000000001
10000000000000000001010000001101110111101
11000001110101011111011110001101110111101
11110111 1110101 101111010001100000000001
11111111 1111111 111111111111101110111101
11111111111111111111111111111101110111101
10000000000000000000000000000000000000001
10000000000000110111111111111111111111111
100000000011111001
111111110011100011
10000000001110111
101111111111101
100000000000101
100000000000101
111111111110101
111111111110101
111111111110E01
111111111111111
